NO  textures/red.xpm
SO  textures/greyscale.xpm
EA  textures/eagle.xpm
WE  textures/purplestone.xpm
F 110,100,10
C 150,150,250

 1111111 
1000N0001
 1110111 
   101
   101
   101
   111  



