1111111111111
10010000001C1
1C00011110011
1P0011E000001
1111111111111