1111111111111111111
1000000000000000001
10000C0000000000001
1000000000000000001
100C000000000000001
1000000000000000001
1111111111111111111