111111
100001
100001
100001
1CPE01
111111