1111111111111111111111111111111111111111
11111011111111111111111111110N0111111111
1111100111111000111111111100010001111111
1111110000000C10000111111100C11111111111
1111100111101110110111111101111111111111
1111101111101111100000000001111111100001
1111101111101111101111111111111111101111
11000P00011000111011111111111111111E1111
1101101101111111101111111111111111101111
1101111101111111101111111111111111101111
11011111000000011000000000000000N0000011
11000C1100011100001111111111111111111011
1111111111111111111111111111111111111111