1111111111111111111111111111111111111111
1000000000000000000100000000000000000011
1C11111110111111110101111111101111111C11
100000000000N000000000000000000000000011
1011111110111110111111101111101111111011
1000011110000110000100001100001111000011
1011111110110111110101111101101111111011
101100000000011111010111110NN00000011111
100001111011000000N00000000110111100EC11
1111111110110110111011101101101111111111
1111111111110110100000101101111111111111
1111111111110110111111101101111111111111
1111111111110110111111101101111111111111
100000000000000000P0000000000000N0000011
1011111110110111111111111101101111111011
1011111110110111111111111101101111111011
1000000110110000001110000001101100N00011
1C11110111110111111111111101111101111C11
100000000N000000000000000000000000000011
1111111111111111111111111111111111111111