1111111111111
10010C00000C1
1C0001111C000
1P0011E000001
1111111111110